"","Names","Gender.x","AmountOfNames.x","Gender.y","AmountOfNames.y","Total"
"1","Emma","F",20415,"F",19414,39829
"2","Olivia","F",19638,"F",19246,38884
"3","Sophia","F",17381,"F",16070,33451
"4","Ava","F",16340,"F",16237,32577
"5","Isabella","F",15574,"F",14722,30296
"6","Mia","F",14871,"F",14366,29237
"7","Charlotte","F",11381,"F",13030,24411
"8","Abigail","F",12371,"F",11699,24070
"9","Emily","F",11766,"F",10926,22692
"10","Harper","F",10283,"F",10733,21016
